Berlin : berlin
Stuttgart : stuttgart
Munich : munchen
Potsdam : potsdam
Bremen : bremen
Hamburg : hamburg
Wiesbaden : wiesbaden
Schwerin : schwerin
Hanover : hannover
Dusseldorf : dusseldorf
Mainz : mainz
Saarbrucken : saarbrucken
Dresden : dresden
Magdeburg : magdeburg
Kiel : kiel
Erfurt : erfurt
Leipzig : leipzig
Nuremburg : nurnberg
Augsburg : augsburg
Mannheim : mannheim
Frankfurt-am-Main : frankfurtammain
Cologne : koln
Dortmund : dortmund
Essen : essen
Rostock : rostock
Bonn : bonn
Munster : munster
Bielefeld : bielefeld
Gottingen : gottingen
Vienna : wien
Bregenz : bregenz
Innsbruck : innsbruck
Graz : graz
Salzburg : salzburg
Linz : linz
Sankt-Polten : sanktpolten
Klagenfurt : klagenfurt
Eisenstadt : eisenstadt
Zurich : zurich
Geneva : genf
Basel : basel
Berne : bern
Lausanne : lausanne
Aarau : arau
Saint-Gallen : stgallen
Lucerne : luzern
Lugano : lugano
Davos : davos
Brussels : brussel
Sofia : sofia
Budapest : budapest
London : london
Liverpool : liverpool
Manchester : manchester
Glasgow : glasgow
Edinburgh : edinburgh
Athens : athen
Copenhagen : kopenhagen
Dublin : dublin
Madrid : madrid
Roma : rom
Monastir : monastir
Larnaca : larnaka
Nicosia : nikosia
Luxembourg-Ville : luxemburg
Riga : riga
Vilnius : vilnius
Sliema : valetta
Amsterdam : amsterdam
Lisboa : lissabon
Warsaw : warschau
Bucharest : bukarest
Ljubljana : ljubljana
Bratislava : bratislava
Paris : paris
Helsinki : helsinki
Kishinev : kishinev
Zagreb : zagreb
Kaliningrad : kalinengrad
Prague : prag
Stockholm : stockholm
Daugavpils : daugavpils
Jurmala : jurmala
Klaipeda : klaipeda
Tartu : tartu
Narva-Joesuu : narva
Kaunas : kaunas
Tallinn : tallinn
Nizhny-Novgorod : nijnovgorod
Rostov-Na-Donu : rostovnadonu
Kazan : kazan
Krasnodar : krasnodar
Ufa : ufa
Perm : perm
Tyumen : tyumen
Yekaterinburg : yekaterinburg
Moscow : moskau
Saint-Petersburg : stpetersburg
Omsk : omsk
Tomsk : tomsk
Surgut : surgut
Krasnoyarsk : krasnoyarsk
Irkutsk : erkutsk
Novosibirsk : nowosibirsk
Chita : cheta
Taraz : dzhambul
Kokshetau : kokshetau
Semey : semipalatinsk
Tashkent : taschent
Donetsk : donetsk
Kyiv : kiev
Kharkiv : kharkiv
Odessa : odessa
Lvov : lvov
Dnepropetrovsk : dnepropetrovsk
Uzhgorod : uzhgorod
Cherkassy : cherkassy
Astana : astana
Almaty : almaty
Karagandy : karaganda
Kostanay : kustanai
Astana : tselinograd
Chernihiv : chernigov
Dushanbe : dushanbe
Minsk : minsk
Istanbul : istanbul
Antalya : antalya
Belek : belek
Izmir : izmir
Alanya : alanya
Ankara : ankara
Cairo : kairo
Hurghada : hurghada
Sharm-ash-Shaykh : sharmelsheikh
Marsa-al-Alam : marsaalam
Dahab : dahab
Tunis : tunesien
Netanya : netania
Petah-Tikva : petah
Rishon-Leziyyon : reshon
Haifa : hayfa
Tel-Aviv-Yafo : telaviv
Jerusalem : ierusalim
Ashdod : ashdod
Be-Er-Sheva : baersheva
Catanzaro : borgiashadrach
Las-Palmas : laspalmas
Santa-Cruz-de-Tenerife : santacruzdetenerife
Barcelona : barselona
Malaga : malaga
Nice : nice
Cannes : cannes
Marseille : marcel
Napoli : neapel
Heraklion : iraclion
Venice : venice
Dubrovnik : dubrovnik
Heraklion : kreta
Thessalonika : thessaloniki
Balchik : albena
Chicago : chicago
Miami : miami
Montreal : monreal
Quebec : kvebek
New-York : newyork
Washington-DC : washington
Los-Angeles : losangeles
San-Francisco : sanfrancisco
Tokyo-1 : tokyo
Sao-Paolo : saopaulo
Beijing : pekin
Hong-Kong : hongkong
Manila : manila
Kuala-Lumpur : kualalumpur
Colombo-1 : kolombo
Cape-Town : capetown
Delhi : delhi
Panama : panama
Santiago : santiyago
Bogota : bogato
Caracas : karakas
Havana : havana
Mexico-City : mexiko
Canberra : canberra
Ottawa : ottawa
Toronto : toronto
Darwin : darvin
Wellington-4 : wellington
Melbourne : melbourne
Sydney : sydney
Auckland : auckland
Bangkok : bangkok
Dubai : dubai
Rio-de-Janeiro : riodejaneiro
Buenos-Aires : buenosaires
Simferopol : simferopol
Sevastopol : sevastopol
Yalta : yalta
Feodosiya : feodosiya
Kerch : kerch
Bodrum : bodrum